...###.##.##.#....##..#.#.
..##.#.####.##.##.#..#.##.
.##.......#.##.##.#.#.....
##....@...#.##.##.#.#..##.
#.........#.##.##.#..#.##.
###..###..#....##.#.#.....
..#..#....#....##.#.......
.##.##.#...........##..#..
.#......#..##....#.##.#...
.#.....##..#..#.#.##..#.##
.#.#...#.#.##......#..#..#
..#..#....#.##..!........#
.##..##.#....#.....#..#.##
.#......##.#..##.#.##.....
.#.....##.##.##.#.##.##...
.##..##.........#....##...
.#.....#...#.#....#.....##
.#######.##.##.#.##.##.##.